💀,⬛,⬛,⬛,🐁,⬛,⬛,⬛,⬛,⬛,⬛
💀,⬛,⬛,🧱,⬛,⬛,⬛,🧱,⬛,⬛,⬛
💀,⬛,⬛,🧱,⬛,🧱,⬛,⬛,⬛,⬛,⬛
💀,⬛,⬛,🧱,⬛,⬛,⬛,🧱,⬛,⬛,⬛
💀,⬛,⬛,⬛,⬛,⬛,⬛,⬛,⬛,🧱,🧀