💀,⬛,⬛,⬛,🐁,🧱,⬛,⬛,⬛,⬛,⬛
💀,⬛,⬛,🧱,⬛,⬛,⬛,🧱,💀,🧱,💀
💀,⬛,⬛,🧱,⬛,🧱,⬛,⬛,⬛,🧱,💀
💀,⬛,⬛,🧱,💀,⬛,⬛,🧱,⬛,⬛,⬛
💀,⬛,⬛,⬛,⬛,🧱,⬛,⬛,⬛,⬛,⬛
💀,⬛,⬛,🧱,⬛,⬛,⬛,🧱,⬛,🧱,⬛
💀,⬛,⬛,🧱,⬛,🧱,⬛,⬛,💀,🧱,⬛
💀,⬛,⬛,🧱,💀,⬛,⬛,🧱,⬛,⬛,⬛
💀,⬛,⬛,🧱,⬛,🧱,⬛,⬛,⬛,🧱,⬛
💀,⬛,⬛,⬛,⬛,🧱,⬛,⬛,⬛,🧱,🧀